Hardy	HP	Attack
Docile	HP	Def
Proud	HP	Sp.Atk.
Quirky	HP	Sp.Def.
Lazy	HP	Speed
Desperate	Atk.	HP
Lonely	Atk.	Def.
Adamant	Atk.	Spec.Atk.
Naughty	Atk.	Spec.Def.
Brave	Atk.	Speed
Stark	Def		HP
Bold	Def.	Atk.
Impish	Def.	Spec.Atk
Lax	Def.	Spec.Def.
Relaxed	Def.	Speed
Bashful	Spec.Atk.	HP
Modest	Spec.Atk.	Atk.
Mild	Spec.Atk.	Def
Rash	Spec.Atk.	Spec.Def
Quiet	Spec.Atk.	Speed
Sickly	Spec.Def	HP
Calm	Spec.Def	Atk.
Gentle	Spec.Def	Def
Careful	Spec.Def	Spec.Atk.
Sassy	Spec.Def	Speed
Serious	Speed	HP
Timid	Speed	Atk.
Hasty	Speed	Def
Jolly	Speed	Spec.Atk.
Naive	Speed	Spec.Def
Composed	none	none
Dull	none	none
Patient	none	none
Poised	none	none
Stoic	none	none
